5656545646
6   7 7  5
5   7 7  6
6   7    5
5   7 7776
6   7 7  5
5   7 7  6
6        5
56666    6
6565656565