2222222242
2      1 2
2      1 2
21111  1 2
2        2
2111111  2
2       72
2 3    772
2 3      4
2422222222